int-pl2.ise.eng.osaka-u.ac.jp	PLC	disabled*...		
int-pl1.ise.eng.osaka-u.ac.jp	PLC	disabled*...		
planetlab1.poznan.rd.tp.pl	PLC	disabled*...		
planetlab2.poznan.rd.tp.pl	PLC	disabled*...		
planetlab4.poznan.rd.tp.pl	PLC	disabled*...		
planetlab3.poznan.rd.tp.pl	PLC	disabled*...		
planetlab2.kreonet.net	PLC	reinstall*...		
csplanet2.ncat.edu	PLC	reinstall*...		
plab1.psgtech.ac.in	PLC	reinstall*...		
planet2.cdacb.ernet.in	PLC	reinstall*...		
planetlab1.kreonet.net	PLC	reinstall*...		
planetlab1.cnu.ac.kr	PLC	reinstall*...		
node1.planetlab.uprr.pr	PLC	reinstall*...		
planetlab-2.unk.edu	PLC	reinstall*...		
planetlab-1.unk.edu	PLC	reinstall*...		
planetlab-01.kyushu.jgn2.jp	PLC	reinstall*...		
node2.planetlab.uprr.pr	PLC	reinstall*...		
planet1.cdacb.ernet.in	PLC	reinstall*...		
planet-2.utn.edu.ar	PLC	reinstall*...		
pl4.coep.org.in	PLC	reinstall*...		
opal.cnu.ac.kr	PLC	reinstall*...		
pl3.coep.org.in	PLC	reinstall*...		
planetlab2.lsd.ufcg.edu.br	PLC	reinstall*...		
mlab3.gr-ix.gr	PLC	disabled*...		
mlab1.gr-ix.gr	PLC	disabled*...		
mlab2.gr-ix.gr	PLC	disabled*...		
planetlab04.uncc.edu	PLC	disabled*...		
node4.planet-lab.titech.ac.jp	PLC	boot...		
planetlab2.n.info.eng.osaka-cu.ac.jp	PLC	safeboot...		
planetlab1.n.info.eng.osaka-cu.ac.jp	PLC	boot...		
planetlab3.gmf.ufcg.edu.br	PLC	disabled*...		
planetlab2.keldysh.ru	PLC	boot...		
mnc1.pusan.ac.kr	PLC	boot...		
planetlab1.piotrkow.rd.tp.pl	PLC	failboot...		
pl1.dce.edu	PLC	reinstall*...		
csplanet1.ncat.edu	PLC	reinstall*...		
planetlab1.it.uts.edu.au	PLC	reinstall*...		
planetlab2.it.uts.edu.au	PLC	reinstall*...		
planetlab1.cs.duke.edu	PLC	disabled*...		
planetlab3.cs.duke.edu	PLC	disabled*...		
planetlab1.csail.mit.edu	PLC	disabled*...		
planetlab2.csail.mit.edu	PLC	disabled*...		
uw1.accretive-dsl.nodes.planet-lab.org	PLC	reinstall*...		
planetlab1.ias.csusb.edu	PLC	failboot...		
planetlab1.cs.dartmouth.edu	PLC	boot...		
planetlab2.cs.dartmouth.edu	PLC	failboot...		
planetlab1.iiitb.ac.in	PLC	reinstall*...		
planetlab2.iiitb.ac.in	PLC	reinstall*...		
plnodea.plaust.edu.cn	PLC	boot...		
planetlab1.rdfrancetelecom.com	PLC	reinstall*...		
planetlab2.rdfrancetelecom.com	PLC	reinstall*...		
planetlab1.lsd.ufcg.edu.br	PLC	reinstall*...		
planetlab1.keldysh.ru	PLC	boot...		
planetlab2.piotrkow.rd.tp.pl	PLC	failboot...		
planetlab1.iitr.ernet.in	PLC	boot...		
planetlab3.cs.uiuc.edu	PLC	boot...		
planetlab-2.webedu.ccu.edu.tw	PLC	boot...		
planet2.scs.cs.nyu.edu	PLC	failboot...		
planetlab03.uncc.edu	PLC	disabled*...		
node1.planet-lab.titech.ac.jp	PLC	boot...		
node3.planet-lab.titech.ac.jp	PLC	boot...		
pllab1.kamgu.ru	PLC	failboot...		
pllab2.kamgu.ru	PLC	failboot...		
pl5.planetlab.uvic.ca	PLC	reinstall*...		
planetlab1.cs.uchicago.edu	PLC	failboot...		
planetlab5.cs.duke.edu	PLC	boot...		
planetlab-2.rml.ryerson.ca	PLC	boot*...		
planetlab2.aub.edu.lb	PLC	boot*...		
planetlab1.aub.edu.lb	PLC	boot*...		
planetlab-1.vuse.vanderbilt.edu	PLC	boot...		
planetlab2.iin-bit.com.cn	PLC	failboot...		
planetlab2.olsztyn.rd.tp.pl	PLC	boot...		
pl2.bit.uoit.ca	PLC	failboot...		
planetlab-1.rml.ryerson.ca	PLC	boot*...		
planetlab2.cs.unb.ca	PLC	boot*...		
planet-lab.iki.rssi.ru	PLC	boot*...		
plab2.psgtech.ac.in	PLC	boot*...		
planetlab1.cs.unb.ca	PLC	boot*...		
itchy.cs.uga.edu	PLC	boot...		
scratchy.cs.uga.edu	PLC	boot*...		
planetlab1.nowogrodzka.rd.tp.pl	PLC	failboot...		
pl4.planetlab.uvic.ca	PLC	failboot...		
planetlab2.iitr.ernet.in	PLC	boot...		
planetlab0.ias.csusb.edu	PLC	boot...		
pl1.bit.uoit.ca	PLC	boot...		
planetlab2.cse.msu.edu	PLC	boot...		
planetlab2.utep.edu	PLC	boot...		
node0.planetlab.etl.luc.edu	PLC	boot...		
opencloud-01.cs.princeton.edu	PLC	reinstall*...		
mnc2.pusan.ac.kr	PLC	boot...		
pl2.ernet.in	PLC	boot*...		
planetlab1.cs.wayne.edu	PLC	boot...		
planetlab2.cse.nd.edu	PLC	failboot...		
charon.cs.binghamton.edu	PLC	boot...		
planetlab1.homelinux.org	PLC	boot*...		
plnode01.cs.mu.oz.au	PLC	boot...		
planetlab-2.vuse.vanderbilt.edu	PLC	boot...		
node1.planetlab.etl.luc.edu	PLC	boot...		
planetlab2.iitb.ac.in	PLC	boot*...		
planetlab1.iitb.ac.in	PLC	boot*...		
planetlab1.iin-bit.com.cn	PLC	boot...		
planetlab02.uncc.edu	PLC	failboot...		
planetlab2.cs.duke.edu	PLC	boot...		
pl2.cewit.stonybrook.edu	PLC	boot...		
pl1.cewit.stonybrook.edu	PLC	boot...		
planetlab-1a.ics.uci.edu	PLC	boot...		
planetlab2.nileu.edu.eg	PLC	boot...		
planetlab1.nileu.edu.eg	PLC	boot...		
planetlabnode-1.docomolabs-usa.com	PLC	boot...		
planetlab1.simula.no	PLC	boot...		
planetlab3.n.info.eng.osaka-cu.ac.jp	PLC	boot...		
planetlabnode-2.docomolabs-usa.com	PLC	boot...		
planetlab2.nowogrodzka.rd.tp.pl	PLC	failboot...		
pluto.cs.binghamton.edu	PLC	boot...		
planet3.cs.ucsb.edu	PLC	boot...		
pn1-planetlab.huawei.com	PLC	boot...		
pn2-planetlab.huawei.com	PLC	boot...		
planetlab1.lublin.rd.tp.pl	PLC	failboot...		
planetlab1.citadel.edu	PLC	boot...		
planetlab1.gdansk.rd.tp.pl	PLC	failboot...		
planetlab4.cse.nd.edu	PLC	boot...		
planetlab2.bgu.ac.il	PLC	failboot...		
planetlab6.cs.uiuc.edu	PLC	boot...		
pl2.csl.utoronto.ca	PLC	boot...		
whitefall.planetlab.cs.umd.edu	PLC	boot...		
planetlab3.canterbury.ac.nz	PLC	boot...		
planetlab2.cs.uit.no	PLE	boot		
orbpl2.rutgers.edu	PLC	boot...		
planetlab-02.ece.uprm.edu	PLC	boot...		
planetlab3.csee.usf.edu	PLC	failboot...		
orbpl1.rutgers.edu	PLC	boot...		
plab1.engr.sjsu.edu	PLC	boot...		
planetlab01.cs.washington.edu	PLC	boot...		
planetlab2.cs.stevens-tech.edu	PLC	boot...		
planetlab3.bupt.edu.cn	PLC	failboot...		
plab-1.sinp.msu.ru	PLC	boot...		
planetlab1.netmedia.gist.ac.kr	PLC	boot...		
planetlab1.di.unito.it	PLE	boot		
plab2.nec-labs.com	PLC	boot...		
planetlab2.umassd.edu	PLC	boot...		
planetlab-2.cs.auckland.ac.nz	PLC	boot...		
planetlab1.eecs.umich.edu	PLC	boot...		
planetlab1.cs.uiuc.edu	PLC	boot...		
planetlab3.postel.org	PLC	boot...		
pl3.sos.info.hiroshima-cu.ac.jp	PLC	failboot...		
plgmu4.ite.gmu.edu	PLC	boot...		
planetlab-2.cs.colostate.edu	PLC	boot...		
planetlab4.netmedia.gist.ac.kr	PLC	failboot...		
planetslug7.cse.ucsc.edu	PLC	boot...		
plgmu3.ite.gmu.edu	PLC	boot...		
planetlab2.ustc.edu.cn	PLC	boot...		
planetlab2.dtc.umn.edu	PLC	boot...		
planetlab1.warsaw.rd.tp.pl	PLC	boot...		
planetlab2.poly.edu	PLC	boot...		
pub2-s.ane.cmc.osaka-u.ac.jp	PLC	boot...		
planetslug4.cse.ucsc.edu	PLC	boot...		
pl1.planetlab.uvic.ca	PLC	failboot...		
server2.planetlab.iit-tech.net	PLC	boot...		
planet1.cs.rochester.edu	PLC	boot...		
nodea.howard.edu	PLC	boot...		
planet12.csc.ncsu.edu	PLC	boot...		
plab-2.sinp.msu.ru	PLC	boot...		
pub1-s.ane.cmc.osaka-u.ac.jp	PLC	boot...		
planetlab7.millennium.berkeley.edu	PLC	boot...		
planetlabeu-2.tssg.org	PLE	boot		
planetlab02.alucloud.com	PLC	boot...		
planetlab-6.ece.iastate.edu	PLC	boot...		
planet2.dsp.ac.cn	PLC	boot...		
planetlab3.cse.nd.edu	PLC	boot...		
pl2.eecs.utk.edu	PLC	boot...		
miranda.planetlab.cs.umd.edu	PLC	boot...		
planetlab1.umassd.edu	PLC	boot...		
planetlab4.canterbury.ac.nz	PLC	boot...		
planet0.jaist.ac.jp	PLC	boot...		
planet-lab-node1.netgroup.uniroma2.it	PLE	failboot		
plnode-04.gpolab.bbn.com	PLC	boot...		
planet1.dsp.ac.cn	PLC	boot...		
planetlab-2.cs.ucy.ac.cy	PLE	boot		
planetlab1.utep.edu	PLC	boot...		
planetlab2.cs.purdue.edu	PLC	boot...		
planetlab1.netlab.uky.edu	PLC	boot...		
planetlab2.buaa.edu.cn	PLC	boot...		
planetlab7.cs.duke.edu	PLC	boot...		
pl2.sos.info.hiroshima-cu.ac.jp	PLC	boot...		
planetlab5.cs.uiuc.edu	PLC	boot...		
planetlab2.cs.columbia.edu	PLC	boot...		
planetlab1.tudelft.nl	PLC	failboot...		
kc-sce-plab2.umkc.edu	PLC	boot...		
nodeb.howard.edu	PLC	boot...		
planetlab-02.kusa.ac.jp	PLC	boot...		
pl2.ucs.indiana.edu	PLC	boot...		
planck250ple.test.iminds.be	PLE	reinstall*		
planetx.scs.cs.nyu.edu	PLC	boot...		
planetlab02.lums.edu.pk	PLC	failboot...		
planetlab2.cs.ucl.ac.uk	PLC	boot...		
planetlab16.millennium.berkeley.edu	PLC	failboot...		
planetlab1.hust.edu.cn	PLC	boot...		
node01.verivue.princeton.edu	PLC	failboot...		
pl1.pku.edu.cn	PLC	boot...		
node02.verivue.princeton.edu	PLC	failboot...		
planet3.cs.huji.ac.il	PLE	boot		
planetlab1.williams.edu	PLC	failboot...		
planetlab1.iii.u-tokyo.ac.jp	PLC	boot...		
planetlab01.alucloud.com	PLC	boot...		
planetlab2-santiago.lan.redclara.net	PLC	boot...		
planetlab02.just.edu.jo	PLC	boot...		
planetlab-2.usask.ca	PLC	boot...		
mlc2.measurementlab.net	PLC	reinstall*...		
planetlab4.eecs.umich.edu	PLC	failboot...		
planetlab-n2.wand.net.nz	PLC	boot...		
mlc1.measurementlab.net	PLC	reinstall*...		
planetlab1.koganei.itrc.net	PLC	boot...		
chronos.disy.inf.uni-konstanz.de	PLE	boot		
planetlab2.cnds.jhu.edu	PLC	failboot...		
saturn.cs.brown.edu	PLC	boot...		
planetlab2.iiitd.edu.in	PLC	safeboot*...		
planetlab-3.cs.ucy.ac.cy	PLE	safeboot		
planetlab-2.elisa.cpsc.ucalgary.ca	PLC	failboot...		
roam2.cs.ou.edu	PLC	boot...		
planetlab1.tb.hiit.fi	PLE	failboot		
planetlab-1.webedu.ccu.edu.tw	PLC	failboot...		
plnodeb.plaust.edu.cn	PLC	failboot...		
planet-lab2.ufabc.edu.br	PLC	boot...		
planetlab1.otemachi.wide.ad.jp	PLC	boot...		
planetlab1.cs.aueb.gr	PLE	boot		
plab1.nec-labs.com	PLC	failboot...		
planetlab2-saopaulo.lan.redclara.net	PLC	boot...		
planetlab2.cs.uoregon.edu	PLC	boot...		
planetlab2.di.fct.unl.pt	PLE	boot		
planetlab3.cslab.ece.ntua.gr	PLE	failboot		
earth.cs.brown.edu	PLC	boot...		
planetlab1.di.fct.unl.pt	PLE	boot		
planetlab1.cs.stevens-tech.edu	PLC	boot...		
planetlab2.jhu.edu	PLC	boot...		
planetlab6.flux.utah.edu	PLC	boot...		
planetlab3.eecs.northwestern.edu	PLC	boot...		
planet-plc-5.mpi-sws.org	PLC	boot...		
agni.iitd.ernet.in	PLC	disabled*...		
planetlab7.csres.utexas.edu	PLC	boot...		
planet-plc-3.mpi-sws.org	PLC	boot...		
venus.silicon-valley.ru	PLC	boot...		
onelab3.info.ucl.ac.be	PLE	boot		
planetlab3.netmedia.gist.ac.kr	PLC	boot...		
planetlab1.eee.hku.hk	PLC	boot...		
vn4.cse.wustl.edu	PLC	boot...		
planet11.csc.ncsu.edu	PLC	boot...		
planet-plc-2.mpi-sws.org	PLC	boot...		
planetlab1.inf.ethz.ch	PLC	boot...		
planetlab3.singaren.net.sg	PLC	boot...		
planetlab5.williams.edu	PLC	boot...		
planetlab-3.imperial.ac.uk	PLE	boot		
adrastea.mcs.suffolk.edu	PLC	boot...		
planetlab-01.bu.edu	PLC	boot...		
plonk.cs.uwaterloo.ca	PLC	boot...		
planetlabb.engr.ccny.cuny.edu	PLC	boot...		
pluto.cs.brown.edu	PLC	boot...		
planetlab5.csail.mit.edu	PLC	boot...		
vayu.iitd.ernet.in	PLC	disabled*...		
planetlab4.warsaw.rd.tp.pl	PLC	boot...		
pl2.zju.edu.cn	PLC	boot...		
planetlab2.eee.hku.hk	PLC	boot...		
planetslug5.cse.ucsc.edu	PLC	boot...		
lab1.asmdba.com	PLC	boot*...		
planetlab-node-01.ucd.ie	PLE	reinstall*		
planetlab2.cs.uml.edu	PLC	boot...		
planetlab-01.vt.nodes.planet-lab.org	PLC	boot...		
planetlab1.cs.ucl.ac.uk	PLC	boot...		
planet1.scs.cs.nyu.edu	PLC	boot...		
cs-planetlab4.cs.surrey.sfu.ca	PLC	boot...		
planetlab2.citadel.edu	PLC	boot...		
planetlab1.pop-ce.rnp.br	PLC	boot...		
planetlaba.engr.ccny.cuny.edu	PLC	disabled*...		
ple1.cesnet.cz	PLE	boot		
planetlab2.cs.umass.edu	PLC	boot...		
planetlab1.arizona-gigapop.net	PLC	failboot...		
planetlab2.csie.nuk.edu.tw	PLC	boot...		
newbootcd.cs.princeton.edu	PLC	boot...		
righthand.eecs.harvard.edu	PLC	safeboot...		
planetlab1.montefiore.ulg.ac.be	PLE	boot		
planetlab2.ntu.nodes.planet-lab.org	PLC	boot...		
planetlab2.fct.ualg.pt	PLE	boot		
75-130-96-12.static.oxfr.ma.charter.com	PLC	boot...		
planetlab2.eecs.umich.edu	PLC	boot...		
node1.planetlab.mathcs.emory.edu	PLC	boot...		
planetlab2.montefiore.ulg.ac.be	PLE	boot		
icnalplabs2.epfl.ch	PLE	boot		
planetlab1.bgu.ac.il	PLC	boot...		
kc-sce-plab1.umkc.edu	PLC	boot...		
csplanetlab4.kaist.ac.kr	PLC	boot...		
planetlab4.inf.ethz.ch	PLC	boot...		
planetlab1.just.edu.jo	PLC	failboot...		
planetlab1.cqupt.edu.cn	PLC	boot...		
pl2.planetlab.uvic.ca	PLC	disabled*...		
planetlab1.unineuchatel.ch	PLE	boot*		
planetlab2.arizona-gigapop.net	PLC	failboot...		
planetlab2.fri.uni-lj.si	PLE	reinstall*		
ple02.fc.univie.ac.at	PLE	reinstall*		
planetlab1.research.nicta.com.au	PLE	boot*		
planetlab1.ifi.uio.no	PLE	boot*		
planetlab1.polito.it	PLE	reinstall*		
planetlab-um10.di.uminho.pt	PLE	reinstall*		
planetlab1.virtues.fi	PLE	reinstall*		
pl2.prakinf.tu-ilmenau.de	PLE	boot		
ple41.planet-lab.eu	PLE	boot		
planetlab01.dis.unina.it	PLE	failboot		
pl1.ccsrfi.net	PLE	boot*		
planetlab-2.research.netlab.hut.fi	PLE	boot*		
planetlab1.ru.is	PLE	disabled*		
planetlab-4.iscte.pt	PLE	boot*		
iraplab1.iralab.uni-karlsruhe.de	PLE	boot		
iason.inf.uth.gr	PLE	boot*		
planetlab1.ionio.gr	PLE	boot*		
planet1.inf.tu-dresden.de	PLE	boot*		
planetlab1.um.es	PLE	reinstall*		
planetlab15.millennium.berkeley.edu	PLC	boot...		
onelab1.warsaw.rd.tp.pl	PLE	reinstall*		
onelab2.warsaw.rd.tp.pl	PLE	boot*		
planetlab2.s3.kth.se	PLE	reinstall*		
planetlab2.pjwstk.edu.pl	PLE	reinstall*		
planetlab1.ucsc.cmb.ac.lk	PLC	failboot...		
planetlab-1.calpoly-netlab.net	PLC	boot...		
planetlab2.millennium.berkeley.edu	PLC	boot...		
planetlab2.iii.u-tokyo.ac.jp	PLC	boot...		
planetlab2.cs.wayne.edu	PLC	failboot...		
of-planet5.stanford.edu	PLC	failboot...		
planetlab2.een.orst.edu	PLC	boot...		
planetlab-3.iscte.pt	PLE	boot*		
planetlab2.eurecom.fr	PLE	boot*		
planetlab-2.man.poznan.pl	PLE	boot*		
planetlab1.millennium.berkeley.edu	PLC	boot...		
planetlab01.erin.utoronto.ca	PLC	boot...		
planetlab6.cs.cornell.edu	PLC	boot...		
planetlab1.ece.ucdavis.edu	PLC	boot...		
planetlab2.cs.uchicago.edu	PLC	failboot...		
planetlab-2a.ics.uci.edu	PLC	boot...		
planetlab-3.ics.uci.edu	PLC	boot...		
planck249ple.test.iminds.be	PLE	reinstall*		
nw144.csie.ncu.edu.tw	PLC	failboot...		
planetlab1.een.orst.edu	PLC	boot...		
planetlab2.netmedia.gist.ac.kr	PLC	failboot...		
planetlab2.dit.upm.es	PLE	boot*		
planetlab-1.cs.unibas.ch	PLE	boot*		
planetlab-1.imag.fr	PLE	boot*		
planetlab2.ci.pwr.wroc.pl	PLE	boot*		
planetlab2.tau.ac.il	PLE	failboot		
uoepl1.essex.ac.uk	PLE	boot*		
planetlab-1.ece.iastate.edu	PLC	boot...		
planetlab-2.pdl.nudt.edu.cn	PLC	failboot...		
uoepl2.essex.ac.uk	PLE	boot*		
planetlab-1.di.fc.ul.pt	PLE	reinstall*		
planetlab-2.di.fc.ul.pt	PLE	reinstall*		
planetlab-1.research.netlab.hut.fi	PLE	boot*		
planetlab1.swidnik.rd.tp.pl	PLC	failboot...		
fobos.cecalc.ula.ve	PLC	boot...		
pierre.iet.unipi.it	PLE	reinstall*		
marie.iet.unipi.it	PLE	boot*		
planetlab2.eecs.wsu.edu	PLC	boot...		
planetlab1.ci.pwr.wroc.pl	PLE	boot*		
planetlab2.unineuchatel.ch	PLE	boot*		
planetlab02.erin.utoronto.ca	PLC	boot...		
planetlab4.cslab.ece.ntua.gr	PLE	boot*		
planetlab2.gdansk.rd.tp.pl	PLC	failboot...		
planetlab-4.dis.uniroma1.it	PLE	boot*		
planetlab1.diku.dk	PLE	boot*		
planetlab2.diku.dk	PLE	boot*		
planetlab1.pjwstk.edu.pl	PLE	reinstall*		
planetlab1.ics.forth.gr	PLE	reinstall*		
planetlab2.ics.forth.gr	PLE	reinstall*		
planetlab-node-02.ucd.ie	PLE	reinstall*		
planetlab-02.naist.jp	PLC	boot...		
planetlab-03.naist.jp	PLC	boot...		
planetlab-04.naist.jp	PLC	boot...		
planetlab3.cs.uchicago.edu	PLC	boot...		
planetlab6.millennium.berkeley.edu	PLC	safeboot...		
planetlab4.millennium.berkeley.edu	PLC	safeboot...		
planetlab-node1.it-sudparis.eu	PLE	reinstall*		
planetlab-3.cmcl.cs.cmu.edu	PLC	boot...		
planetlab-1.cs.uic.edu	PLC	boot...		
planetlab3.millennium.berkeley.edu	PLC	failboot...		
planetlab3.cs.st-andrews.ac.uk	PLE	reinstall*		
ple01.fc.univie.ac.at	PLE	reinstall*		
pl1.tailab.eu	PLE	boot*		
planetlab4.cs.uchicago.edu	PLC	boot...		
planet1.cs.huji.ac.il	PLE	reinstall*		
planetlab4.cs.duke.edu	PLC	boot...		
planetlab4.singaren.net.sg	PLC	boot...		
planetlab2.informatik.uni-erlangen.de	PLE	boot*		
planetlab1.tmit.bme.hu	PLE	reinstall*		
planetlab-1.man.poznan.pl	PLE	reinstall*		
plab2.ple.silweb.pl	PLE	boot*		
planetlab1.willab.fi	PLE	reinstall*		
ait05.us.es	PLE	reinstall*		
f20bootcd.cs.princeton.edu	PLC	boot...		
planet2.ku.edu.tr	PLC	boot...		
planetlab-1.pdl.nudt.edu.cn	PLC	boot...		
planetlab-13.e5.ijs.si	PLE	boot*		
planetlab-1.ida.liu.se	PLE	boot		
planetlab1.dojima.wide.ad.jp	PLC	boot...		
planetlab2.cs.aueb.gr	PLE	reinstall*		
onelab7.iet.unipi.it	PLE	boot*		
planetlab1.mini.pw.edu.pl	PLE	boot*		
planet2.zib.de	PLE	reinstall*		
plato.di.uoa.gr	PLE	boot*		
planetlab1.eurecom.fr	PLE	boot*		
planetlab1.iitkgp.ac.in	PLC	boot...		
planetlab3.ucsd.edu	PLC	boot...		
planetlab-2.ida.liu.se	PLE	boot		
planetlab-01.kusa.ac.jp	PLC	boot...		
planet6.cs.ucsb.edu	PLC	boot...		
planetlab4.cs.uiuc.edu	PLC	boot...		
ple2.hpca.ual.es	PLE	boot*		
planetlab11.millennium.berkeley.edu	PLC	boot...		
planetlab2.singaren.net.sg	PLC	boot...		
planetlab-01.cs.angelo.edu	PLC	disabled*...		
planetlab06.cs.washington.edu	PLC	safeboot...		
planetlab5.cs.cornell.edu	PLC	boot...		
planetlabtwo.ccs.neu.edu	PLC	boot...		
plab3.ple.silweb.pl	PLE	boot		
planetlab11.net.in.tum.de	PLE	boot		
planet-plc-6.mpi-sws.org	PLC	boot...		
planetlab2.ewi.tudelft.nl	PLC	failboot...		
pl-node-1.csl.sri.com	PLC	failboot...		
pl3.cs.unm.edu	PLC	boot...		
75-130-96-13.static.oxfr.ma.charter.com	PLC	boot...		
planet-plc-1.mpi-sws.org	PLC	failboot...		
plab3.nec-labs.com	PLC	disabled*...		
planetlab02.sys.virginia.edu	PLC	boot...		
planetlab-2.ece.iastate.edu	PLC	boot...		
planetlab2.plab.ege.edu.tr	PLC	boot...		
planetlab-01.ece.uprm.edu	PLC	boot...		
planet4.cc.gt.atl.ga.us	PLC	boot...		
orval.infonet.fundp.ac.be	PLE	boot*		
planetlab2.polito.it	PLE	reinstall*		
peeramide.irisa.fr	PLE	boot*		
planetlab1.csie.nuk.edu.tw	PLC	boot...		
planetlab1.tamu.edu	PLC	failboot...		
pl3.planet.cs.kent.edu	PLC	boot...		
planetlab2.iitkgp.ac.in	PLC	boot...		
planetlab7.csail.mit.edu	PLC	boot...		
peeramidion.irisa.fr	PLE	boot*		
ple1.tu.koszalin.pl	PLE	reinstall*		
planet2.cs.huji.ac.il	PLE	reinstall*		
planet1.servers.ua.pt	PLE	boot*		
planetlab1.clemson.edu	PLC	boot...		
planetlab01.tkn.tu-berlin.de	PLE	boot*		
inriarennes1.irisa.fr	PLE	reinstall*		
planetlab3.georgetown.edu	PLC	boot...		
planetlab1lannion.elibel.tm.fr	PLE	boot*		
planetlab0.otemachi.wide.ad.jp	PLC	boot...		
planetlab4.georgetown.edu	PLC	boot...		
planetlab2lannion.elibel.tm.fr	PLE	boot*		
planetlab1.s3.kth.se	PLE	reinstall*		
planetlab1.tsuniv.edu	PLC	boot...		
dev-res-plab-02.tid.es	PLE	reinstall*		
dev-res-plab-01.tid.es	PLE	boot*		
pl01.comp.polyu.edu.hk	PLC	failboot...		
planetlab1.cnis.nyit.edu	PLC	boot...		
cs743.cs.nthu.edu.tw	PLC	boot*...		
cs744.cs.nthu.edu.tw	PLC	boot*...		
pli1-pa-5.hpl.hp.com	PLC	boot...		
planetlab2.ie.cuhk.edu.hk	PLC	boot...		
planetlab-1.cs.auckland.ac.nz	PLC	boot...		
planetlab1.pop-rs.rnp.br	PLC	boot...		
planetlab2.informatik.uni-wuerzburg.de	PLE	boot*		
planetlab2.cnis.nyit.edu	PLC	boot...		
planetlab2.clemson.edu	PLC	boot...		
plutarch.di.uoa.gr	PLE	boot*		
planetlab1.uc3m.es	PLE	reinstall*		
planetlab2.uc3m.es	PLE	reinstall*		
ops.ii.uam.es	PLE	reinstall*		
planetlab-12.e5.ijs.si	PLE	reinstall*		
planetlab1.eecs.jacobs-university.de	PLE	boot*		
prometeusz.we.po.opole.pl	PLE	reinstall*		
planetlab2.cs.uiuc.edu	PLC	boot...		
planetlab-2.imag.fr	PLE	boot*		
mtuplanetlab1.cs.mtu.edu	PLC	boot...		
planetlab01.ethz.ch	PLE	boot*		
pl1.yonsei.ac.kr	PLC	boot...		
planet-lab2.cs.ucr.edu	PLC	boot...		
pl1.eecs.utk.edu	PLC	boot...		
aguila1.lsi.upc.edu	PLE	reinstall*		
planetlab02.ethz.ch	PLE	boot*		
planetlab1.singaren.net.sg	PLC	boot...		
planetlab02.dis.unina.it	PLE	reinstall*		
planetlab1.urv.cat	PLE	boot*		
planetlab01.cs.tcd.ie	PLE	boot*		
planetlab4.cs.st-andrews.ac.uk	PLE	reinstall*		
planet2.itc.auth.gr	PLE	reinstall*		
planet2.inf.tu-dresden.de	PLE	safeboot*		
ple3.planet-lab.eu	PLE	boot		
planet1.cc.gt.atl.ga.us	PLC	boot...		
planetlab2.willab.fi	PLE	reinstall*		
planetlab1.science.unitn.it	PLE	boot*		
planetlab2.sics.se	PLE	boot*		
node1pl.planet-lab.telecom-lille1.eu	PLE	boot*		
planetlab-1.cs.ucy.ac.cy	PLE	disabled*		
planetlab4.csail.mit.edu	PLC	boot...		
server4.planetlab.iit-tech.net	PLC	boot...		
planetlab-1.iscte.pt	PLE	boot*		
planetlab2.aston.ac.uk	PLE	reinstall*		
pl2.tailab.eu	PLE	boot*		
pl1.cis.uab.edu	PLC	boot...		
planetlab4.bupt.edu.cn	PLC	boot...		
pl221nassau0.cs.princeton.edu	PLC	boot...		
mlabtest.cs.princeton.edu	PLC	reinstall*...		
planet-lab2.uba.ar	PLC	boot...		
planetlab10.millennium.berkeley.edu	PLC	boot...		
planetlab2.engr.uconn.edu	PLC	boot...		
nis-planet1.doshisha.ac.jp	PLC	boot...		
pl2.cis.uab.edu	PLC	boot...		
planet1.jaist.ac.jp	PLC	boot...		
planetlab-3.ece.iastate.edu	PLC	boot...		
planetlab1.csuohio.edu	PLC	boot...		
planetlab1.tlm.unavarra.es	PLE	reinstall*		
planetlab-1.cse.ohio-state.edu	PLC	boot...		
netapp6.cs.kookmin.ac.kr	PLC	failboot...		
medea.inf.uth.gr	PLE	boot*		
planetlab2.csg.uzh.ch	PLE	reinstall*		
planetlab12.millennium.berkeley.edu	PLC	boot...		
planet1.zib.de	PLE	boot*		
node2.planetlab.albany.edu	PLC	boot...		
planetlab04.cnds.unibe.ch	PLE	reinstall*		
planetlab3.di.unito.it	PLE	boot		
osiris.planetlab.cs.umd.edu	PLC	boot...		
planetlab1.fri.uni-lj.si	PLE	reinstall*		
gschembra3.diit.unict.it	PLE	reinstall*		
planetlab-um00.di.uminho.pt	PLE	reinstall*		
itchy.comlab.bth.se	PLE	disabled*		
planetlab03.cnds.unibe.ch	PLE	reinstall*		
planetlab-2.fhi-fokus.de	PLE	boot*		
planetlab5.goto.info.waseda.ac.jp	PLC	failboot...		
node2pl.planet-lab.telecom-lille1.eu	PLE	boot*		
planetlab2.cis.upenn.edu	PLC	boot...		
planetlab2.pop-rs.rnp.br	PLC	boot...		
pl1.cs.unm.edu	PLC	boot...		
planet1.ku.edu.tr	PLC	boot...		
node1.planetlab.albany.edu	PLC	boot...		
planetlab2.ionio.gr	PLE	boot*		
planetlab2.xeno.cl.cam.ac.uk	PLE	boot		
planetlab1.wiwi.hu-berlin.de	PLE	reinstall*		
planetlab1.mta.ac.il	PLE	boot*		
planetlab-2.cs.unibas.ch	PLE	safeboot*		
planetlab2.mta.ac.il	PLE	boot*		
ait21.us.es	PLE	reinstall*		
planetlab02.cnds.unibe.ch	PLE	reinstall*		
planetlab-1.fhi-fokus.de	PLE	boot*		
planetlab1.poly.edu	PLC	boot...		
node2.planetlab.uni-luebeck.de	PLE	boot*		
lim-planetlab-1.univ-reunion.fr	PLE	reinstall*		
planetlab2.science.unitn.it	PLE	boot*		
planetlab3.informatik.uni-wuerzburg.de	PLE	boot*		
planetlab2.ifi.uio.no	PLE	boot*		
planetlab-3.dis.uniroma1.it	PLE	reinstall*		
onelab6.iet.unipi.it	PLE	boot*		
planetlab1.fct.ualg.pt	PLE	boot*		
ple1.dmcs.p.lodz.pl	PLE	reinstall*		
host3-plb.loria.fr	PLE	reinstall*		
planetlab1.esprit-tn.com	PLE	reinstall*		
pl2.cs.unm.edu	PLC	boot...		
planetlab14.millennium.berkeley.edu	PLC	safeboot...		
planetlab1.rutgers.edu	PLC	boot...		
planetlab4.csee.usf.edu	PLC	failboot...		
planet1.itc.auth.gr	PLE	reinstall*		
planetlabpc0.upf.edu	PLE	boot*		
planetlab1.sics.se	PLE	boot*		
planetlab2.csres.utexas.edu	PLC	failboot...		
planetlab-01.naist.jp	PLC	boot...		
planetlab1.cs.umb.edu	PLC	boot...		
node1.planetlab.uni-luebeck.de	PLE	reinstall*		
planetlab2.cs.umb.edu	PLC	boot...		
planetlab2.uc.edu	PLC	boot...		
planetlab1.uc.edu	PLC	failboot...		
planetvs1.informatik.uni-stuttgart.de	PLE	reinstall*		
planetlab1.thlab.net	PLE	boot*		
pandora.we.po.opole.pl	PLE	boot*		
planet2.scs.stanford.edu	PLC	boot...		
planetlab3.csail.mit.edu	PLC	boot...		
planet-lab1.ufabc.edu.br	PLC	boot...		
planetlab01.lums.edu.pk	PLC	failboot...		
planetlab2.mnlab.cti.depaul.edu	PLC	boot...		
planetlab2.emich.edu	PLC	boot...		
planetlab2.informatik.uni-kl.de	PLE	reinstall*		
planetlab-node3.it-sudparis.eu	PLE	boot*		
chimay.infonet.fundp.ac.be	PLE	boot*		
ple1.hpca.ual.es	PLE	boot*		
planetlab1.cse.msu.edu	PLC	boot...		
deimos.cecalc.ula.ve	PLC	boot...		
planetlab4.csres.utexas.edu	PLC	boot...		
rochefort.infonet.fundp.ac.be	PLE	boot*		
planetlab2.lublin.rd.tp.pl	PLC	failboot...		
planetlab1.csres.utexas.edu	PLC	failboot...		
planetlab1.eecs.northwestern.edu	PLC	failboot...		
planet2.servers.ua.pt	PLE	boot*		
plab1.cs.ust.hk	PLC	boot...		
planetlab0.ucsc.cmb.ac.lk	PLC	boot...		
planetlab2.jcp-consult.net	PLE	boot*		
planetlab2.eas.asu.edu	PLC	boot...		
planet2.l3s.uni-hannover.de	PLE	boot*		
planetlab3.csres.utexas.edu	PLC	failboot...		
planetlab1.eas.asu.edu	PLC	boot...		
planetlab1.jcp-consult.net	PLE	boot*		
planetlab2.research.nicta.com.au	PLE	reinstall*		
aguila2.lsi.upc.edu	PLE	reinstall*		
planet1.l3s.uni-hannover.de	PLE	boot*		
planetlab13.millennium.berkeley.edu	PLC	boot...		
arari.snu.ac.kr	PLC	boot...		
planetlab2.ece.ucdavis.edu	PLC	safeboot...		
planetlab2.wiwi.hu-berlin.de	PLE	boot*		
planetlab3.piotrkow.rd.tp.pl	PLC	safeboot...		
onelab3.warsaw.rd.tp.pl	PLE	boot*		
planetlab2.virtues.fi	PLE	reinstall*		
planetlab2.netlab.uky.edu	PLC	boot...		
planet1.scs.stanford.edu	PLC	boot...		
lim-planetlab-2.univ-reunion.fr	PLE	reinstall*		
planetlab2.tlm.unavarra.es	PLE	reinstall*		
gschembra4.diit.unict.it	PLE	reinstall*		
plgmu1.ite.gmu.edu	PLC	boot...		
nw142.csie.ncu.edu.tw	PLC	failboot...		
planetlab1.plab.ege.edu.tr	PLC	boot...		
mtuplanetlab2.cs.mtu.edu	PLC	boot...		
planetlab1.csg.uzh.ch	PLE	reinstall*		
planetlab2.tmit.bme.hu	PLE	boot*		
pl2.ccsrfi.net	PLE	boot*		
scratchy.comlab.bth.se	PLE	disabled*		
planetlab8.millennium.berkeley.edu	PLC	boot...		
planetlab1.byu.edu	PLC	boot...		
planetlab-2.cs.uic.edu	PLC	boot...		
plab2.larc.usp.br	PLC	boot...		
planetlab-03.vt.nodes.planet-lab.org	PLC	boot...		
planetlab-tea.ait.ie	PLE	boot*		
nis-planet2.doshisha.ac.jp	PLC	failboot...		
ple2.tu.koszalin.pl	PLE	boot*		
planetlab4.flux.utah.edu	PLC	boot...		
planetlab01.uncc.edu	PLC	boot...		
planetlab1.ewi.tudelft.nl	PLC	boot...		
onelab4.warsaw.rd.tp.pl	PLE	boot*		
planetlab2.thlab.net	PLE	boot*		
planetlabpc1.upf.edu	PLE	boot*		
planetlab-02.cs.princeton.edu	PLC	safeboot...		
planetlab2.eecs.jacobs-university.de	PLE	boot*		
planetlab-coffee.ait.ie	PLE	reinstall*		
planetlab1.aston.ac.uk	PLE	reinstall*		
utet.ii.uam.es	PLE	reinstall*		
planetlab2.mini.pw.edu.pl	PLE	boot*		
planetlab02.cs.tcd.ie	PLE	boot*		
planetlab2.urv.cat	PLE	boot*		
planetlab2.esprit-tn.com	PLE	reinstall*		
ple2.dmcs.p.lodz.pl	PLE	reinstall*		
planetlab1.jhu.edu	PLC	boot...		
planetlab2.bupt.edu.cn	PLC	failboot...		
planetlab1.dit.upm.es	PLE	boot*		
host2.planetlab.informatik.tu-darmstadt.de	PLE	reinstall*		
planetlab3.informatik.uni-erlangen.de	PLE	boot*		
planetlab2.ru.is	PLE	disabled*		
inriarennes2.irisa.fr	PLE	reinstall*		
planetlab02.tkn.tu-berlin.de	PLE	boot*		
planetlab6.cs.duke.edu	PLC	boot...		
planetlab-1.cs.colostate.edu	PLC	boot...		
planetlab1.informatik.uni-erlangen.de	PLE	boot*		
planetlab1.iis.sinica.edu.tw	PLC	boot...		
planet-plc-4.mpi-sws.org	PLC	boot...		
planetlab-2.iscte.pt	PLE	boot*		
planetlab4.cnds.jhu.edu	PLC	boot...		
planetlab13.net.in.tum.de	PLE	boot		
planetlab-4.ece.iastate.edu	PLC	boot...		
planetlab1-santiago.lan.redclara.net	PLC	boot...		
planetlab9.millennium.berkeley.edu	PLC	boot...		
planetlab0.dojima.wide.ad.jp	PLC	failboot...		
cs-planetlab3.cs.surrey.sfu.ca	PLC	boot...		
planetlab2-tijuana.lan.redclara.net	PLC	boot...		
server3.planetlab.iit-tech.net	PLC	boot...		
plab3.eece.ksu.edu	PLC	boot...		
planetlab2.utt.fr	PLE	boot		
plab2.cs.ust.hk	PLC	boot...		
planetlab2.eecs.ucf.edu	PLC	boot...		
planetlab2.eecs.northwestern.edu	PLC	failboot...		
puri.mimuw.edu.pl	PLE	boot		
plab1.larc.usp.br	PLC	failboot...		
planetlab1-tijuana.lan.redclara.net	PLC	boot...		
planetlab1-saopaulo.lan.redclara.net	PLC	boot...		
planetlab6.csail.mit.edu	PLC	boot...		
ple2.det.uvigo.es	PLE	boot		
planetlab1.cse.nd.edu	PLC	failboot...		
planetlab-2.infotech.monash.edu.my	PLC	reinstall*...		
planetlab2.csuohio.edu	PLC	failboot...		
planetlab-1.infotech.monash.edu.my	PLC	reinstall*...		
ks.measurementlab.net	PLC	reinstall*...		
onelab4.info.ucl.ac.be	PLE	boot		
planetlab05.cs.washington.edu	PLC	boot...		
vn5.cse.wustl.edu	PLC	boot...		
ttu2-1.nodes.planet-lab.org	PLC	boot...		
planetlab2.byu.edu	PLC	boot...		
planetlab1.cis.upenn.edu	PLC	boot...		
planetlab3.cs.columbia.edu	PLC	boot...		
pl2-higashi.ics.es.osaka-u.ac.jp	PLC	boot...		
planetlab5.millennium.berkeley.edu	PLC	boot...		
planetlab1.cs.umass.edu	PLC	boot...		
metis.mcs.suffolk.edu	PLC	boot...		
planet-lab1.cs.ucr.edu	PLC	boot...		
planetlab1.ntu.nodes.planet-lab.org	PLC	boot...		
kulcha.mimuw.edu.pl	PLE	boot		
pl3.planetlab.uvic.ca	PLC	boot...		
plgmu2.ite.gmu.edu	PLC	boot...		
planetlab3.xeno.cl.cam.ac.uk	PLE	boot		
mercury.silicon-valley.ru	PLC	boot...		
pl1.cs.yale.edu	PLC	boot...		
planetlab1.cs.columbia.edu	PLC	boot...		
vicky.planetlab.ntua.gr	PLE	boot		
cse-white.cse.chalmers.se	PLE	boot		
planetlab1.net.in.tum.de	PLE	reinstall*		
ple2.ait.ac.th	PLE	boot*		
planetlab2.upm.ro	PLE	boot		
pl2.yonsei.ac.kr	PLC	boot...		
planetlab1.ucsd.edu	PLC	boot...		
planet2.cc.gt.atl.ga.us	PLC	boot...		
planet4.cs.ucsb.edu	PLC	boot...		
ple42.planet-lab.eu	PLE	boot		
pln.zju.edu.cn	PLC	boot...		
planetlab1.pop-rj.rnp.br	PLC	failboot...		
pl2.cs.yale.edu	PLC	boot...		
plab4.eece.ksu.edu	PLC	boot...		
planetlab5.flux.utah.edu	PLC	boot...		
planetlab6.csres.utexas.edu	PLC	boot...		
nuc1.planet-lab.eu	PLE	boot		
planetlab7.flux.utah.edu	PLC	boot...		
planetlab4.cs.cornell.edu	PLC	reinstall*...		
planetlab5.csres.utexas.edu	PLC	boot...		
planetlab3.cs.cornell.edu	PLC	reinstall*...		
planet5.cs.ucsb.edu	PLC	boot...		
planetlab1.utdallas.edu	PLC	boot...		
planetlab2.c3sl.ufpr.br	PLC	boot...		
planet-lab-node2.netgroup.uniroma2.it	PLE	boot		
server1.planetlab.iit-tech.net	PLC	boot...		
planet1.elte.hu	PLE	boot		
ricepl-5.cs.rice.edu	PLC	boot...		
pl4.sos.info.hiroshima-cu.ac.jp	PLC	failboot...		
planet1.unipr.it	PLE	boot		
planetlab1.engr.uconn.edu	PLC	boot...		
plab1.eecs.qmul.ac.uk	PLE	boot		
planet2.unipr.it	PLE	boot		
planetlab2.iis.sinica.edu.tw	PLC	boot...		
roam1.cs.ou.edu	PLC	boot...		
planet1.pnl.nitech.ac.jp	PLC	boot...		
planetlab2.unl.edu	PLC	boot...		
plab2.engr.sjsu.edu	PLC	boot...		
planetlab1.cs.vu.nl	PLE	boot		
planetlab2.pop-rj.rnp.br	PLC	failboot...		
planetlab6.goto.info.waseda.ac.jp	PLC	boot...		
pli1-pa-1.hpl.hp.com	PLC	boot...		
pnode1.pdcc-ntu.singaren.net.sg	PLC	boot...		
planetlab6.csee.usf.edu	PLC	boot...		
planetlab4.ie.cuhk.edu.hk	PLC	boot...		
plnode02.cs.mu.oz.au	PLC	boot...		
pl2snu.koren.kr	PLC	failboot...		
planetlab2.williams.edu	PLC	boot...		
planetlab1.mnlab.cti.depaul.edu	PLC	boot...		
planetlab-5.ece.iastate.edu	PLC	boot...		
planetlab2.hust.edu.cn	PLC	boot...		
pli1-pa-6.hpl.hp.com	PLC	boot...		
planetlab2.cti.espol.edu.ec	PLC	boot...		
planet-lab3.uba.ar	PLC	boot...		
plnode-03.gpolab.bbn.com	PLC	boot...		
planetlab1.eecs.ucf.edu	PLC	boot...		
jupiter.cs.brown.edu	PLC	boot...		
mars.planetlab.haw-hamburg.de	PLE	boot		
recall.snu.ac.kr	PLC	boot...		
planetlab2.tamu.edu	PLC	failboot...		
planetlab4.tamu.edu	PLC	boot...		
planetlab2.ucsd.edu	PLC	boot...		
planetlab2.temple.edu	PLC	boot...		
pl1.planet.cs.kent.edu	PLC	boot...		
pli1-pa-2.hpl.hp.com	PLC	boot...		
pl2.planet.cs.kent.edu	PLC	failboot...		
ple4.planet-lab.eu	PLE	boot		
planetlab4.n.info.eng.osaka-cu.ac.jp	PLC	boot...		
ebb.colgate.edu	PLC	failboot...		
planetlab1.acis.ufl.edu	PLC	boot...		
planetlab1.eecs.wsu.edu	PLC	boot...		
pnode2.pdcc-ntu.singaren.net.sg	PLC	boot...		
planetlab4.postel.org	PLC	boot...		
plgmu5.ite.gmu.edu	PLC	failboot...		
planetlab1.nakao-lab.org	PLC	failboot...		
planetlab-1.ssvl.kth.se	PLC	boot...		
planetlab-2.sjtu.edu.cn	PLC	boot...		
planetlab1.tau.ac.il	PLE	failboot		
planetlab1.buaa.edu.cn	PLC	boot...		
pl1.csl.utoronto.ca	PLC	boot...		
planetlab1-buenosaires.lan.redclara.net	PLC	boot...		
aladdin.planetlab.extranet.uni-passau.de	PLE	boot		
planetlab01.sys.virginia.edu	PLC	boot...		
planetlab02.cs.washington.edu	PLC	boot...		
ricepl-4.cs.rice.edu	PLC	boot...		
planetlab2.nakao-lab.org	PLC	boot...		
pl1snu.koren.kr	PLC	boot...		
ple2.cesnet.cz	PLE	boot		
planetlab2.tb.hiit.fi	PLE	failboot		
planet3.cc.gt.atl.ga.us	PLC	boot...		
planet2.cs.rochester.edu	PLC	boot...		
csplanetlab3.kaist.ac.kr	PLC	boot...		
planetlab3.tamu.edu	PLC	failboot...		
planetlab1.bupt.edu.cn	PLC	failboot...		
planetlab-1.usask.ca	PLC	boot...		
planetlab-1.scie.uestc.edu.cn	PLC	boot...		
pli1-pa-3.hpl.hp.com	PLC	boot...		
planetlab-1.elisa.cpsc.ucalgary.ca	PLC	boot...		
pl1-higashi.ics.es.osaka-u.ac.jp	PLC	boot...		
planet-lab1.itba.edu.ar	PLC	boot...		
planetlab3.comp.nus.edu.sg	PLC	boot...		
pli1-pa-4.hpl.hp.com	PLC	boot...		
pl-node-0.csl.sri.com	PLC	boot...		
host4-plb.loria.fr	PLE	reinstall*		
planetlab-2.ing.unimo.it	PLE	failboot		
onelab2.pl.sophia.inria.fr	PLE	boot		
planetlab-4.imperial.ac.uk	PLE	reinstall*		
planet2.pnl.nitech.ac.jp	PLC	boot...		
pl1.ucs.indiana.edu	PLC	boot...		
planetlab2.postel.org	PLC	boot...		
plab3.cs.msu.ru	PLC	boot...		
onelab1.pl.sophia.inria.fr	PLE	boot		
planetlab1.pop-pa.rnp.br	PLC	boot...		
icnalplabs1.epfl.ch	PLE	boot		
planetlab2.tsuniv.edu	PLC	boot...		
planetlab2.um.es	PLE	boot		
planetlab3.net.in.tum.de	PLE	reinstall*		
planetlab2.u-strasbg.fr	PLE	boot		
dschinni.planetlab.extranet.uni-passau.de	PLE	boot		
ple1.det.uvigo.es	PLE	boot		
planetlab2.informatik.uni-goettingen.de	PLE	boot		
planetlab-1.sjtu.edu.cn	PLC	boot...		
planetlab2.cs.du.edu	PLC	boot...		
planetlab1.c3sl.ufpr.br	PLC	boot...		
plab2.eecs.qmul.ac.uk	PLE	boot		
ple43.planet-lab.eu	PLE	boot		
planetlab3.arizona-gigapop.net	PLC	failboot...		
planetlab1.cs.ucla.edu	PLC	boot...		
cse-yellow.cse.chalmers.se	PLE	boot		
planetlab-1.ing.unimo.it	PLE	boot		
planetlab3.williams.edu	PLC	boot...		
pl-dccd-01.cua.uam.mx	PLC	boot...		
ricepl-1.cs.rice.edu	PLC	boot...		
planetlab2.cs.unc.edu	PLC	boot...		
planetlab-js2.cert.org.cn	PLC	boot...		
planetlab1.cs.cornell.edu	PLC	boot...		
pl02.comp.polyu.edu.hk	PLC	failboot...		
plab4.ple.silweb.pl	PLE	boot		
planetlab1.cs.purdue.edu	PLC	failboot...		
planetlab4.mini.pw.edu.pl	PLC	boot...		
planetlab2.inf.ethz.ch	PLC	boot...		
netapp7.cs.kookmin.ac.kr	PLC	failboot...		
planetlab4.williams.edu	PLC	boot...		
lefthand.eecs.harvard.edu	PLC	boot...		
planetlab2.cesnet.cz	PLC	failboot...		
planetlab2.cs.uoi.gr	PLE	boot		
pl-dccd-02.cua.uam.mx	PLC	boot...		
planet4.cs.huji.ac.il	PLE	boot		
pl4.cs.unm.edu	PLC	failboot...		
flow.colgate.edu	PLC	failboot...		
ttu1-1.nodes.planet-lab.org	PLC	boot...		
kupl2.ittc.ku.edu	PLC	boot...		
dplanet2.uoc.edu	PLE	boot		
planetlab2.pop-pa.rnp.br	PLC	boot...		
planetlab2.pop-mg.rnp.br	PLC	boot...		
ricepl-2.cs.rice.edu	PLC	boot...		
planetlab-4.eecs.cwru.edu	PLC	boot...		
dplanet1.uoc.edu	PLE	boot		
planetlab2.csee.usf.edu	PLC	boot...		
jupiter.planetlab.carleton.ca	PLC	boot...		
planetlab2.cs.colorado.edu	PLC	failboot...		
ple1.ait.ac.th	PLE	boot*		
planetlab3.cnds.jhu.edu	PLC	boot...		
planetlab2.cs.vu.nl	PLE	boot		
pl1.sos.info.hiroshima-cu.ac.jp	PLC	boot...		
planetlab2.rutgers.edu	PLC	boot...		
planetlab3.mini.pw.edu.pl	PLC	failboot...		
planetlab2.koganei.itrc.net	PLC	boot...		
planetlab-02.vt.nodes.planet-lab.org	PLC	boot...		
planetlab1.cnds.jhu.edu	PLC	boot...		
kupl1.ittc.ku.edu	PLC	boot...		
pl2.rcc.uottawa.ca	PLC	failboot...		
planetlab3.eecs.umich.edu	PLC	boot...		
planetlab2.uta.edu	PLC	boot...		
planetlab-2.cmcl.cs.cmu.edu	PLC	boot...		
planetlab2.sfc.wide.ad.jp	PLC	boot...		
planetlab5.eecs.umich.edu	PLC	boot...		
pl2.uni-rostock.de	PLE	boot		
planetlabone.ccs.neu.edu	PLC	boot...		
planetlab-02.bu.edu	PLC	boot...		
planetlab2.di.unito.it	PLE	boot		
pl1.eng.monash.edu.au	PLC	boot...		
node2.planetlab.mathcs.emory.edu	PLC	boot...		
planetlab2-buenosaires.lan.redclara.net	PLC	boot...		
stella.planetlab.ntua.gr	PLE	boot		
planetlab1.xeno.cl.cam.ac.uk	PLE	boot		
pl2.eng.monash.edu.au	PLC	boot...		
planetlab2.acis.ufl.edu	PLC	boot...		
host3.planetlab.informatik.tu-darmstadt.de	PLE	boot		
plink.cs.uwaterloo.ca	PLC	boot...		
planetlab1.cs.uoi.gr	PLE	boot		
pl1.rcc.uottawa.ca	PLC	boot...		
plue1.uetpeshawar.edu.pk	PLE	boot		
planetlab-2.calpoly-netlab.net	PLC	boot...		
planetlab-2.tagus.ist.utl.pt	PLE	boot		
planetlab2.cs.pitt.edu	PLC	safeboot...		
planetlab1.cs.uit.no	PLE	boot		
planetlab1.upm.ro	PLE	boot		
planetlab1.pop-mg.rnp.br	PLC	boot...		
planetlab2.pop-ce.rnp.br	PLC	boot...		
planetlab2.cs.ubc.ca	PLC	boot...		
planetlab3.cesnet.cz	PLC	boot...		
planetlab1.cs.uoregon.edu	PLC	boot...		
planetlab1.utt.fr	PLE	boot		
planetlabeu-1.tssg.org	PLE	boot		
planetlab2.unr.edu	PLC	boot...		
planetlab1.sfc.wide.ad.jp	PLC	boot...		
planet2.elte.hu	PLE	boot		
planetlab-1.tagus.ist.utl.pt	PLE	boot		
planetlab4.rutgers.edu	PLC	failboot...		
planetlab3.rutgers.edu	PLC	boot...		
iraplab2.iralab.uni-karlsruhe.de	PLE	boot		
pl2.cs.montana.edu	PLC	boot...		
planetlab1.u-strasbg.fr	PLE	failboot		
merkur.planetlab.haw-hamburg.de	PLE	boot		
planetlab5.ie.cuhk.edu.hk	PLC	boot...		
planetlab-5.eecs.cwru.edu	PLC	boot...		
planetlab1.cesnet.cz	PLC	boot...		
planetvs2.informatik.uni-stuttgart.de	PLE	boot		
planetlab1.uta.edu	PLC	failboot...		
pl1.uni-rostock.de	PLE	boot		
planetlab1.informatik.uni-kl.de	PLE	boot		
planetlab1.informatik.uni-goettingen.de	PLE	boot		
planetlab3.cs.uoregon.edu	PLC	boot...		
planetlab2.cs.ucla.edu	PLC	boot...		
ple44.planet-lab.eu	PLE	boot		
planetlab-1.cmcl.cs.cmu.edu	PLC	boot...		
planetlab1.postel.org	PLC	failboot...		
planetlab1.cs.pitt.edu	PLC	safeboot...		
pl1.prakinf.tu-ilmenau.de	PLE	failboot		
planetlab4.cs.uoregon.edu	PLC	boot...		
planetlab04.cs.washington.edu	PLC	boot...		
planetlab1.cs.ubc.ca	PLC	boot...		
planetlab-2.ssvl.kth.se	PLC	boot...		
planet-lab2.itba.edu.ar	PLC	boot...		
planetlab1.cs.colorado.edu	PLC	failboot...		
planetlab-01.cs.princeton.edu	PLC	boot...		
planetlab2.cqupt.edu.cn	PLC	boot...		
planetlab1.emich.edu	PLC	failboot...		
salt.planetlab.cs.umd.edu	PLC	boot...		
pl2.pku.edu.cn	PLC	boot...		
planetlab1.unr.edu	PLC	boot...		
pl1.cs.montana.edu	PLC	boot...		
planet-lab4.uba.ar	PLC	boot...		
planetlab1.unl.edu	PLC	boot...		
planetlab2.utdallas.edu	PLC	boot...		
planetlab-05.cs.princeton.edu	PLC	boot...		
planetlab1.cs.uml.edu	PLC	boot...		
planetlab-2.sysu.edu.cn	PLC	boot...		
planetlab2.comp.nus.edu.sg	PLC	boot...		
planetlab1.ustc.edu.cn	PLC	boot...		
planetlab1.comp.nus.edu.sg	PLC	boot...		
planetlab2.tudelft.nl	PLC	failboot...		
plab1.cs.msu.ru	PLC	boot...		
planetlab3.wail.wisc.edu	PLC	boot...		
planetlab1.cs.du.edu	PLC	boot...		
planetlab2.cs.okstate.edu	PLC	boot...		
planetlab1.csee.usf.edu	PLC	boot...		
planetlab-js1.cert.org.cn	PLC	boot...		
planetlab-2.cse.ohio-state.edu	PLC	boot...		
planet-lab1.uba.ar	PLC	boot...		
planetlab2.cs.cornell.edu	PLC	boot...		
planetlab1.aut.ac.nz	PLC	boot...		
planetlab-03.cs.princeton.edu	PLC	boot...		
planetlab-04.vt.nodes.planet-lab.org	PLC	boot...		
planetlab-2.scie.uestc.edu.cn	PLC	boot...		
planetlab1.cs.okstate.edu	PLC	boot...		
planetlab2.ecs.vuw.ac.nz	PLC	boot...		
planetlab03.cs.washington.edu	PLC	boot...		
planetlab-n1.wand.net.nz	PLC	boot...		
planetlab1.dtc.umn.edu	PLC	boot...		
planetlab-1.sysu.edu.cn	PLC	boot...		
planetlab1.ie.cuhk.edu.hk	PLC	boot...		
planetlab5.csee.usf.edu	PLC	boot...		
planetlab1.cs.unc.edu	PLC	boot...		
pl2.6test.edu.cn	PLC	boot...		
planetlab-04.cs.princeton.edu	PLC	boot...		
pl1.6test.edu.cn	PLC	boot...		
planetlab2.aut.ac.nz	PLC	failboot...		
planetlab1.ecs.vuw.ac.nz	PLC	boot...		
planetlab3.inf.ethz.ch	PLC	boot...		
planetlab4.wail.wisc.edu	PLC	boot...		
planetlab1.cti.espol.edu.ec	PLC	failboot...		
planetlab1.temple.edu	PLC	boot...		
saturn.planetlab.carleton.ca	PLC	boot...		
planetlab4.goto.info.waseda.ac.jp	PLC	boot...		
planetlab2.simula.no	PLC	disabled*...		
planetlab-02.kyushu.jgn2.jp	PLC	safeboot*...		
datacomngn.cnu.ac.kr	PLC	safeboot*...		